NO ./path_to_the_north_texture
SO ./path_to_the_south_texture
WE ./path_to_the_west_texture
EA ./path_to_the_east_texture

F 220,100,0
C 225,30,0

        11111111111 11111111111111
        10000000001 10000000000001
        10110000011 10000000000001
        10010000001 10000000000001
1111111110110000011 10000000000001
1000000000110000011 10111111111111
111101111111110111  1000010001
111101111111110111 11100100011
110000001101010111 10000010001
100000000000000011 10000100011
100000000000000011 1010010001
110000011101010111 1011110N0111
11110111 1110101   1111010001
11111111 1111111 111111111111